.......T...U........b.
.........V...V...T....
b.....V.....O..V......
.....N...O.O.O.N....b.
....N.N.O.O.O.N.N.....
b....N...O.N...N.E....
.U...R.C..N.N.M.....b.
.......R.C.N.M.M......
b..E.C...R....M....U..
.......C............b.
..T...............T...
b.....................
......................
