......................
......C.C.C.C.C.......
U.....D.D.D.D.D.....U.
V.V.V.....W.....V.V.V.
E.E.E.E.E.E.E.E.E.E.E.
C.C.C.C.C.C.C.C.C.C.C.
A.A.......W.......A.A.
A.A...B.B.B.B.B...A.A.
V.V.V...........V.V.V.
......B.B.B.B.B.......
......................
......................
......................