......................
......................
......E.E...E.E.......
..D.D.V.C.U.C.V.D.D...
..D.D.V.C.U.C.V.D.D...
..G.G.B.B.B.B.B..G.G..
......................
...H.H..........H.H...
.......A.A.A.A........
..G.G.G...FF...G.G.G..
......................
......................
......................
