......................
..U.....A.A.A.....U...
........A.A.A.........
........A.A.A.........
B.B.B.B.......B.B.B.B.
B.B.B.B.......B.B.B.B.
......................
......................
C.C.C.C.......C.C.C.C.
C.C.C.C.......C.C.C.C.
......................
......................
......................