......................
.R.A.A.A.A.A.A.A.A.A..
....................G.
.H..R.U...E.....E.....
......R...E...I..E..G.
.H..U.................
.............S..E...G.
.H.D.D.D.D.D.....E....
....................H.
Q.....................
...................R..
Q......C.C.C.C.C.C....
......................
