......................
..U.......H.......U...
..c..............c....
..nR.C.C...H.C.C.R.n..
......................
...B.B....H....A.A....
S..B...V.....V...A..S.
...B.......H.....A....
...B.............A....
.B.B......H......A.A..
......................
......................
......................