.Y..G............G..Y.
..U.......U.......U...
..b.....b.W.b.....b...
..T.....T.V.T.....T...
.....T....W....T......
T.MNF.....V......FNMT.
..NM.b....W....b..MN..
..A.......V.......A...
ZH.H.H.H.H..H.H.H.H.HZ
......................
........b...b.........
......................
......................
