.......T...U........b.
.........V...V...T....
b.....V.....O..V......
..U..N..B.GO.OHC....b.
....N.N.G...O...H.....
b....N...B....C..L....
.....R.C.....M..L.L.b.
.......R.C..M.M..L....
b..E.C...R...M...E....
.......C............b.
..T...............T...
b.....................
......................
