......................
.R.A.A.A.A.A.A.A.A.A..
....................G.
.H..R.U...............
......R.......I.....G.
.H..U.................
.............S......G.
.H.D.D.D.D.D..........
....................H.
Q.....................
...................R..
Q......C.C.C.C.C.C....
......................