.G..................F.
..U...................
.G..................F.
..C.C.C.C.C.C.C.......
.G..................F.
......................
.G..................F.
......D.D.D.D.D.D.D...
.G..................F.
......................
.G..................F.
..E.E.E.E.E.E.E.......
......................