b...................b.
a...C...W.U.W...C....a
...H..K...A....K..H...
.....L.L..B...L.L.....
.D..M.O.M.U..M.O.M.D..
I..I.L.L.V.V..L.L.I..I
....T.K..V.V...KT.....
.D.....R.....R.....D..
...C.............C....
.....B.........B......
......................
......................
......................
