..........U...........
........A.A.A.........
......A.A.A.A.A.......
....B...A.A.A...B.....
B.B.B.B.......B.B.B.B.
B.B.B.B.......B.B.B.B.
......................
......................
C.C.C.C.......C.C.C.C.
C.C.C.C.......C.C.C.C.
......................
......................
......................
