......................
....C...W.U.W...C.....
..aH..K...A....K..Ha..
.....L.L..B...L.L.....
.D..M...M.U..M...M.D..
I..I.L.L.V.V..L.L.I..I
....T.K..V.V...KT.....
.D.....R.....R.....D..
...C.............C....
.....B.........B......
......................
......................
......................
