....b..V..U..V..b.....
..C...YT.ZT.ZT.Y..C...
.HB.H............HB.H.
..U....V..W..V....U...
..C......M........C...
........M.M...........
l....B...M..M..B.....l
....GD.G...M.MGD.G....
.O...D......M..D....O.
O.O..B..R.R.R..B...O.O
.O..................O.
......................
......................
