......................
......................
..FG..............GF..
......A.A.A.A.A.......
..FG..B.B.B.B.B...GF..
..........U...........
..FG....V.V.V.....GF..
......................
..FG..B.B.B.B.B...GF..
......C.C.C.C.C.......
..FG..............GF..
......................
......................