c........U.U.......c..
b.......W.W.W.......b.
a.YV.V.V.V.V.V.V.V.Y.a
...E.E.E.E.E.E.E.E....
..YE.D.D.D.D.D.D.E.Y..
...E.D.D.D.D.D.D.E....
..YE.E.E.E.E.E.E.E.Y..
...V.V.V.V.V.V.V.V....
......................
......................
......................
......................
......................
