.GL................KF.
..U...................
.G..................F.
..C.C.C.C.C.C.C.......
.GM.................F.
......................
.G.................NF.
......D.D.D.D.D.D.D...
.G..................F.
......................
.GL.................F.
..E.E.E.E.E.E.E.......
......................
