d.................d...
m....................m
..T.E.E.D.U.D.E.E.T...
......b.......b.......
..T.E.J........JE.T...
....J.....U......J....
..T..E.V.V.V.V.E..T...
........F.FF.F........
.F..................F.
....A...........A.....
..A...A.......A...A...
......................
......................
