b...................b.
a.......W.U.W........a
..K...K...A....K...K..
.L.L.L.L..B...L.L.L.L.
M...M...M.U..M...M...M
.L.L.L.L..V...L.L.L.L.
..K...K...V....K...K..
.L.L.L.L.L..L.L.L.L.L.
M...M...M....M...M...M
......................
......................
......................
......................
