......................
........V.U.V.........
......................
.......C.C.C.C........
V.V..H..........H.V.V.
B.U....D.D.D.D....U.B.
B....H.I..E...I.H...B.
..........E...........
A....H.D.D.D.D..H...A.
A...................A.
A...................A.
......................
......................