......................
......................
......E.E...E.E.......
..D.D...C.U.C...D.D...
..D.D...C.U.C...D.D...
......B.B.B.B.B.......
......................
....H.H........H.H....
.......A.A.A.A........
..G.......FF.......G..
......................
......................
......................