......................
..A.A.A...U...A.A.A...
..A.A.A...E...A.A.A...
..........E...........
..E.E...........E.E...
........B.B.B.........
C.C.C...B.B.B...C.C.C.
C.C.C...........C.C.C.
......D.......D.......
........D.D.D.........
......................
......................
......................
