tpn................npt
.......A.A.A.A........
.......A.A.A.A........
.......B.U.B.B........
.......B.B.B.B........
.......C.C.C.C........
.......C.C.C.C........
.......Q.Q.Q.Q........
......................
.......P.P.P.P........
......................
......................
......................