X....C.D.D.....V.....X
...C.......D.V.U.V....
..H..........D.V.D.D..
......D.D......D.....I
.H...H....D...........
........O...J...K...I.
H...M..OaO.....K.K....
.....H..OMO..J..K..N..
.H.......OaO........N.
......H...O...E......N
..C.............O.....
....C............O....
..................O...
