......................
........V.U.V.........
......................
..U....C.C.C.C....U...
V.V..H..........H.V.V.
B......D.D.D.D......B.
B....H.I..E...I.H...B.
..........E...........
A....H.D.D.D.D..H...A.
A...................A.
A...................A.
......................
......................
