......................
..V...W...W...W...V...
..HC.C.C.C.C.C.C.C.H..
........U.C.U.........
..H...D...C...D....H..
......D...C...D.......
..H...D...C...D....H..
......D...C...D.......
..H...D...C...D....H..
.........OC.O.........
..H.....O.C..O.....H..
......................
......................
