e................e....
n......A.A.A.A.......n
.......A.A.A.A........
.....R.B.U.B.B.R......
....a..B.B.B.B...a....
...R...C.C.C.C...R....
.......C.C.C.C........
.R.....Q.Q.Q.Q.....R..
......................
.......P.P.P.P........
......................
......................
......................
