e................e....
d......A.A.A.A....d...
c......A.A.A.A.....c..
b....R.B.U.B.B.R....b.
a......B.B.B.B.......a
...R...C.C.C.C...R....
.......C.C.C.C........
.R.....Q.Q.Q.Q.....R..
......................
.......P.P.P.P........
......................
......................
......................
