d.................d...
m....................m
..T.E.E.D.U.D.E.E.T...
......................
..T..O..........O.T...
....OaO...U....OaO....
..T..O.V.V.V.V..O.T...
........F.FF.F........
.F..................F.
....A...........A.....
..A...A.......A...A...
......................
......................
