......................
..U.......H.......U...
..c.........M....c....
..nR.C.C...H.C.C.R.n..
.........M............
...B.B....H.M..A.A....
S..B...V.....V...A..S.
...B..G..M.H...F.A....
...B.............A....
.B.B...B..H..A...A.A..
......................
......................
......................
