..........A...........
........A.U.A.........
......A...B...A.......
....A...B...B...A.....
..A...B...C...B...A...
A...B...C...C...B...A.
..B...C.......C...B...
....C...........C.....
......................
......................
......................
......................
......................