...Z..E..E.E..E...Z...
.U...J..J....J..J..U..
.W.................W..
......E..a..a.E.......
V.V.V.V.V.V.V.V.V.V.V.
a........HU.H........a
...M..a...C....a..M...
.S..S..S.....S..S..S..
..........A...........
M.Ma..F..F..F..F..aM.M
.M..................M.
M.M....A..A..A.....M.M
......................
