.......T............b.
...........U.....T....
b.....V...V...N.......
.....N...O...N.N....b.
....N.N.O.O...N.......
b....N...O.N.....E....
.U...R.C..N.N.M.....b.
.......R.C.N.M.M......
b..E.C...R....M....U..
.......C............b.
..T...............T...
b.....................
......................