.......T...U........b.
.........V...V...T....
b.....V.....O..V......
..U..N...O.O.O.N....b.
....N.N.O.O.O.N.N.....
b....N...O.N...N.L....
.....R.C..N.N.M.L.L.b.
.......R.C.N.M.M.L....
b..E.C...R..L.M..E....
.......C...L.L......b.
..T.........L.....T...
b.....................
......................
