..........U...........
..A.A.A...E...A.A.A...
..A.A.A...E...A.A.A...
......................
U.E.E...........E.E.U.
........B.B.B.........
C.C.C...B.B.B...C.C.C.
C.C.C...........C.C.C.
......D.......D.......
........D.D.D.........
......................
......................
......................