d.................d...
b...................b.
l.T.E.E.D.U.D.E.E.T..l
......................
..T..O..........O.T...
....O.O...U....O.O....
..T..O.V.V.V.V..O.T...
........F.FF.F........
.F..................F.
....A...........A.....
..A...A.......A...A...
......................
......................