..........V...........
..........U...........
..FA.............A.F..
....F............F....
..A...GB.B.B.B.G..A...
........G....G........
......B...C...B.......
......V.B...B.V.......
..C.C.V.......V.C.C...
......................
......................
......................
......................