b...................b.
a.......W.U.W........a
..K...K...A....K...K..
...L...L..B...L...L...
....M...M.U..M...M....
...L...L..V...L...L...
..K...K...V....K...K..
...L...L......L...L...
....M...M....M...M....
......................
......................
......................
......................