..........U...........
.......A..V..A........
.....A....B....A......
...A......B......A....
.A...A...C.C...A...A..
...C...E.b...E...C....
.C.U.D.........D.U.C..
...C...E...b.E...C....
.C...A...C.C...A...C..
.C.....A..B..A.....C..
.C........B........C..
......................
......................
