..........V...........
..........U...........
..FA.............A.F..
....F............F....
..A...GB.B.B.B.G..A...
........G....G........
......B...C...B.......
.C.H..V.B...B.V...HC..
.H..C.V...C...V.C...H.
..C...............C...
......................
......................
......................
